.S##.....T
#.##..###.
#.###E###E
#T..E.###.
###T#####G
